Ailuropoda melanoleuca	Giant panda	A_melanoleuca	ailMel	Ailuropoda_melanoleuca
Alligator mississippiensis	American alligator	A_mississippiensis	allMis
Anolis carolinensis	Anole Lizard	A_carolinensis	anoCar	Anolis_carolinensis
Anopheles gambiae	Mosquito	A_gambiae	anoGam
Apis mellifera	European honey bee	A. mellifera	A_mellifera	apiMel
Aplysia californica	California sea hare	A_californica	aplCal
Arabidopsis lyrata	Lyrate rockcress	A. lyrata	A_lyrata
Aquilegia coerulea	Colorado blue columbine	A_coerulea
Arabidopsis thaliana	Thale cress	A_thaliana
Arbacia punctulata	Purple-spined sea urchin	A_punctulata
Balaenoptera acutorostrata	Minke whale	B_acutorostrata	balAcu
Bos taurus	Cow	B_taurus	bosTau	Bos_taurus
Brachypodium distachyon	Purple false brome	B_distachyon
Branchiostoma floridae	Lancet	B_floridae	braFlo
Brassica rapa	Field mustard	B_rapa
Caenorhabditis brenneri	C. brenneri (nematode)	C_brenneri	caePb
Caenorhabditis briggsae	C. briggsae (nematode)	C_briggsae	cb
Caenorhabditis elegans	C. elegans (nematode)	C_elegans	ce	Caenorhabditis_elegans
Caenorhabditis japonica	C. japonica (nematode)	C_japonica	caeJap
Caenorhabditis remanei	C. remanei (nematode)	C_remanei	caeRem
Callithrix jacchus	Common marmoset	C_jacchus	calJac	Callithrix_jacchus
Callorhinchus milii	Elephant shark	C_milii	calMil
Candida albicans SC	Yeast (Human Flora) SC	C_albicans_SC
Candida albicans WO	Yeast (Human Flora) WO	C_albicans_WO
Canis lupus familiaris	Dog	C_familiaris	canFam	Canis_familiaris
Capsella rubella	Red shepherd's purse	C_rubella
Carica papaya	Papaya	C_papaya
Cavia porcellus	Guinea pig	C_porcellus	cavPor	Cavia_porcellus
Ceratotherium simum	White rhinoceros	C_simum	cerSim
Chlamydomonas reinhardtii	motile single-celled green alga	C_reinhardtii
Choloepus hoffmanni	Two-toed sloth	C_hoffmanni	choHof	Choloepus_hoffmanni
Chrysemys picta	painted turtle	C_picta	Chrysemys_picta	chrPic
Citrus clementina	Clementine mandarin	C_clementina
Citrus sinensis	Sweet orange	C_sinensis
Ciona intestinalis	vase tunicate (sea squirt)	C_intestinalis	ci	Ciona_intestinalis
Ciona savignyi	Pacific sea squirt C. savignyi	C_savignyi		Ciona_savignyi
Cricetulus griseus	Chinese hamster	C_griseus	criGri
Cucumis sativus	Cucumber	C_sativus
Danio rerio	Zebrafish	D_rerio	danRer	Danio_rerio
Dasypus novemcinctus	Nine-banded armadillo	D_novemcinctus	dasNov	Dasypus_novemcinctus
Dictyostelium discoideum	slime mold	D_discoideum
Drosophila ananassae	D. ananassae (fruit fly)	D_ananassae	droAna
Drosophila erecta	D. erecta (fruit fly)	D_erecta	droEre
Drosophila grimshawi	D. grimshawi (fruit fly)	D_grimshawi	droGri
Drosophila melanogaster	Common fruit fly	D. melanogaster	D_melanogaster	dm	Drosophila_melanogaster
Drosophila mojavensis	D. mojavensis (fruit fly)	D_mojavensis	droMoj
Drosophila persimilis	D. persimilis (fruit fly)	D_persimilis	droPer
Drosophila pseudoobscura	D. pseudoobscura (fruit fly)	D_pseudoobscura	dp
Drosophila sechellia	D. sechelia (fruit fly)	D_sechellia	droSec
Drosophila simulans	D. simulans (fruit fly)	D_simulans	droSim
Drosophila virilis	D. virilis (fruit fly)	D_virilis	droVir
Drosophila yakuba	D. yakuba (fruit fly)	D_yakuba	droYak
Dipodomys ordii	Kangaroo rat	D_ordii	dipOrd	Dipodomys_ordii
Ebola virus	Ebola virus	E_virus	eboVir
Echinops telfairi	Lesser hedgehog tenrec	E_telfairi		Echinops_telfairi	echTel
Equus caballus	Horse	E_caballus	equCab	Equus_caballus
Erinaceus europaeus	European hedgehog	E_europaeus	eriEur	Erinaceus_europaeus
Escherichia coli K12-MG1655	E. coli K12-MG1655	E. coli	E_coli
Euprymna scolopes	Hawaiian bobtail squid	E_scolopes
Eucalyptus grandis	Eucalyptus	E_grandis
Felis catus	House Cat	F_catus	felCat	Felis_catus
Fragaria vesca	woodland strawberry	F_vesca
Gallus gallus	Chicken	G_gallus	galGal	Gallus_gallus
Gasterosteus aculeatus	Stickleback	G_aculeatus	gasAcu	Gasterosteus_aculeatus
Geospiza fortis	medium ground finch	Geospiza_fortis	G_fortis	geoFor
Glycine max	Soybean	G_max	
Gorilla gorilla	Western gorilla	G_gorilla	gorGor	Gorilla_gorilla
Gadus morhua	Atlantic cod	G_morhua	gadMor
Gossypium hirsutum	Upland cotton	G_hirsutum
Gossypium raimondii	Cotton D	G_raimondii
Heterocephalus glaber	Naked mole rat	Heterocephalus_glaber	H_glaber	hetGla
Homo sapiens	Human	H_sapiens	hg	Homo_sapiens
Hordeum vulgare	Barley	H_vulgare
Latimeria chalumnae	Coelacanth	L_chalumnae	latCha
Lemna gibba	Gibbous duckweed	L_gibba
Linum usitatissimum	flax	L_usitatissimum
Loligo pealeii	Longfin inshore squid	L_pealeii
Loxodonta africana	African bush elephant	L_africana	loxAfr	Loxodonta_africana
Lotus japonicus	a model legume	L_japonicus
Macaca mulatta	Rhesus monkey	M_mulatta	rheMac	Macaca_mulatta
Macropus eugenii	Tammar wallaby	M_eugenii		Macropus_eugenii	macEug
Malus domestica	Apple	M_domestica
Manihot esculenta	Cassava	M_esculenta
Medicago truncatula	Barrel medic	M_truncatula	
Meleagris gallopavo	Turkey		M_gallopavo	Meleagris_gallopavo	melGal
Melopsittacus undulatus	Budgie	M_undulatus	melUnd
Microcebus murinus	Gray mouse lemur	M_murinus	micMur	Microcebus_murinus
Mimulus guttatus	Monkey flower	M_guttatus
Monodelphis domestica	Opossum	M_domestica	monDom	Monodelphis_domestica
Monosiga brevicollis	Choanoflagellates	Monosiga_brevicollis
Mus musculus	House mouse	M_musculus	mm	Mus_musculus
Mustela putorius furo	Domesticated ferret	M_putorius	musFur
Mycobacterium abscessus	M. abcessus	M_abscessus	
Mycobacterium smegmatis	M. smegmatis	M_smegmatis	
Mycobacterium tuberculosis	M. tuberculosis	M_tuberculosis	
Myotis lucifugus	Little brown bat	M_lucifugus		Myotis_lucifugus	myoLuc
Nematostella vectensis	starlet sea anemone	N_vectensis
Nicotiana tabacum	Tobacco	N_tabacum
Nomascus leucogenys	Northern white-cheeked gibbon	Nomascus_leucogenys	N_leucogenys	nomLeu
Ochotona princeps	American pika	O_princeps	ochPri	Ochotona_princeps
Oreochromis niloticus	Nile tilapia	O_niloticus	oreNil
Ornithorhynchus anatinus	Platypus	O_anatinus	ornAna	Ornithorhynchus_anatinus
Oryctolagus cuniculus	European rabbit	O_cuniculus		Oryctolagus_cuniculus	oryCun
Oryza sativa indica	Rice (indica)	O_sativa_indica	
Oryza sativa japonica	Rice (japonica)	O_sativa	O_sativa_japonica
Oryzias latipes	Medaka	O_latipes	oryLat	Oryzias_latipes
Otolemur garnettii	Nothern greater galago	O_garnettii	otoGar	Otolemur_garnettii
Ostreococcus lucimarinus	O. lucimarinus	O_lucimarinus	
Ovis aries	sheep	O_aries	OAR	oviAri
Pan paniscus	Bonobo	P_paniscus	panPan	
Pan troglodytes	Chimp	P_troglodytes	panTro	Pan_troglodytes
Panicum virgatum	Switchgrass	P_virgatum
Papio anubis	olive baboon	P_anubis	papAnu
Papio hamadryas	hamadryas baboon	P_hamadryas	papHam
Petromyzon marinus	Lamprey	P_marinus	petMar
Phaseolus vulgaris	Common bean	P_vulgaris
Physcomitrella patens	Moss	P_patens
Pinus taeda	Loblolly Pine	P. taeda	P_taeda
Plasmodium falciparum	P. falciparum	P_falciparum	Pfalciparum_3D7_plasmoDB-5.4	Pfalciparum_3D7_plasmoDB-5.5
Pongo pygmaeus abelii	Orangutan	P_abelii	ponAbe	Pongo_pygmaeus
Populus trichocarpa	Black cottonwood	P_trichocarpa	
Pristionchus pacificus	P. pacificus (nematode)	P_pacificus	priPac
Procavia capensis	Rock hyrax	P_capensis	proCap	Procavia_capensis
Pseudomonas aeruginosa	P_aeruginosa	P. aeruginosa
Pteropus vampyrus	Large flying fox	P_vampyrus	pteVam	Pteropus_vampyrus
Prunus persica	Peach	P_persica
Rattus norvegicus	Rat	R_norvegicus	rn	Rattus_norvegicus
Ricinus communis	Castor oil plant	R_communis
Saccharomyces cerevisiae	Budding Yeast	S_cerevisiae	sacCer	Saccharomyces_cerevisiae
Saimiri boliviensis	squirrel monkey	S_boliviensis	saiBol
Sarcophilus harrisii	Tasmanian devil	Sarcophilus_harrisii	S_harrisii	sarHar
Schizosaccharomyces pombe	Fission Yeast	S_pombe
Selaginella moellendorffii	Spikemoss	S. moellendorffii	S_moellendorffii
Setaria italica	Foxtail millet	S. italica	S_italica
Sigmodon hispidus	Cotton rat	S_hispidus
Sodalis glossinidius	S. glossinidius	S_glossinidius
Solanum lycopersicum	Tomato	S_lycopersicum
Sorex araneus	Eurasian shrew	S_araneus	sorAra	Sorex_araneus
Sorghum bicolor	Sorghum	S_bicolor	
Spermophilus tridecemlineatus	Thirteen-lined ground squirrel	S_tridecemlineatus	speTri	Spermophilus_tridecemlineatus
Strongylocentrotus purpuratus	Purple sea urchin	S_purpuratus	strPur
Sus scrofa	Wild boar	S_scrofa		Sus_scrofa	susScr
Taeniopygia guttata	Zebra finch	T_guttata	taeGut	Taeniopygia_guttata
Takifugu rubripes	Fugu	T_rubripes	fr	Takifugu_rubripes
Tarsius syrichta	Philippine tarsier	T_syrichta	tarSyr	Tarsius_syrichta
Tetraodon nigroviridis	Tetraodon	T_nigroviridis	tetNig	Tetraodon_nigroviridis
Thellungiella halophila	Salt cress	T_halophila
Thellungiella parvula	Anatolian cress	T_parvula
Thermococcus kodakaraensis KOD1	Hyperthermophilic Archaeon	T_kodakaraensis_KOD1	T. kodakaraensis_KOD1	T_kodakaraensis_KOD
Tribolium castaneum	Red flour beetle	T_castaneum
Trichechus manatus latirostris	West Indian manatee	T_manatus	triMan
Triticum aestivum	Common wheat	T_aestivum
Trypanosoma brucei	Protozoan parasites	T_brucei
Tupaia belangeri	Northern tree shrew	T_belangeri	tupBel	Tupaia_belangeri
Tursiops truncatus	Bottlenose dolphin	T_truncatus	turTru	Tursiops_truncatus
Vaccinium corymbosum	blueberry	V_corymbosum
Vicugna pacos	Alpaca	V_pacos	vicPac	Vicugna_pacos
Vitis vinifera	Common grape vine	V_vinifera
Volvox carteri	Volvox	V. carteri	V_carteri
Xenopus laevis	African clawed frog	X_laevis
Xenopus tropicalis	Pipid frog	X_tropicalis	xenTro	Xenopus_tropicalis
Yersinia pestis	Bubonic plague pathogen	Y_pestis
Yersinia pseudotuberculosis	Y. pseudotuberculosis	Y_pseudotuberculosis
Zea mays B73	Maize B73	Z_mays